R 400 840
NO ./texture/WALL16.xpm
SO ./texture/WALL32.xpm
WE ./texture/WALL22.xpm
EA ./texture/WALL76.xpm

S ./texture/SPR_STAT_36.xpm
F 220,100,0 
C 132,181,189


        1111111111111111111111111
        1000000000000000000000021
        1011000000000000000000001
        1001000000000000000000001
111111111011000000000000000000001
100000000000000000000000000011111111111
100000000000000000000000000000000001111
120000000000000000000000000000000000001
110000002000000000000000W00000000000001
100000000000000000000000000000000000001
122000000000000000000000000000000000001
110000011101010111110111100011111111111
11110111 1110101 101111010001
11111111 1111111 111111111111