R 1500    1500
NO ./texture/WALL16.xpm
SO ./texture/WALL32.xpm
WE ./texture/WALL22.xpm
EA ./texture/WALL76.xpm

S ./texture/SPR_STAT_36.xpm
F 220,100,0
C 132,181,189

        1111
        111111111
        111111111111111
        1111111111111111111111111
        1000000000110000000000001
        1011000S01110000002000001
        1001000000000000000000001
111111111011000001110000000000001
100000000011000001110111111111111
1111011111111101110000000000111
11110111111111011101010010001
1100000011010101110000001000111
10002000000200001100000010001
10000000000000001101010010001
1100000111010101111101111000111
11110111 1110101 101111010001
11111111 1111111 111111111111